-25
34
-17
89
111111111111111111111111111111111111111111111111111111111111
111111111111111111111111111111111111111111111111111111111111
111111111111111111111111111111111111111111111111111111111111
111111111111111111111111111111111111111111111111111111111111
110000000000000000000000000000000000000000000000000000000111
110000000000000000000000000000000000000000000000000000000111
110000011111111111111111111110011111111111111111111110000111
110000010000000000000000000000000000000000000000000010000111
110000010000000000000000000000000000000000000000000010000111
110000010000000000000000000000000000000000000000000010000111
110000010000000000000000000000000000000000000000000010000111
110000010000000000000000000000000000000000000000000010000111
110000010000000000000000111100000111100000000000000010000111
110000010000000000000000111100000111100000000000000010000111
110000010000000000000000111100000111100000000000000010000111
110000010000000000000000111100000111100000000000000010000111
110000010000000000000000000000000000000000000000000010000111
110000010000000000000000000000000000000000000000000010000111
110000010000000000000000000000000000000000000000000010000111
110000010000000000000000000000000000000000000000000010000111
110000010000000000000000000000000000000000000000000010000111
110000010000000001000000000000001000000000000000000010000111
110000010000000001000000000000001000000000000000000010000111
110000010000000001000000000000001000000000000000000010000111
110000010000000001000000000000001000000111100000000010000111
110000010000000001111111111111111000000111100000000010000111
110000010000000000000000000000000000000111100000000010000111
110000010000000000000000000000000000000111100000000010000111
110000010000000000000000000000000000000000000000000010000111
110000010000000000000000000000000000000000000000000010000111
110000010000000000000000000000000000000000000000000010000111
110000010000000000000000000000000000000000000000000010000111
110000010000000000000000000000000000000000000000000010000111
110000011111111111111111111111111111111111111111111110000111
110000000000000000000000000000000000000000000000000000000111
110000000000000000000000000000000000000000000000000000000111
110000000000000000000000000000000000000000000000000000000111
110000000000000000000000000000000000000000000000000000000111
110000000000000000000000000000000000000000000000000000000111
110000000000000000000000000000000000000000000000000000000111
110000000000000000000000000000000000000000000000000000000111
110000011111111111111111111110011111111111111111111110000111
110000010000000000000000000000000000000000000000000010000111
110000010000000000000000000000000000000000000000000010000111
110000010000000000000000000000000000000000000000000010000111
110000010000000000000000000000000000000000000000000010000111
110000010000000000000000000000000000000000000000000010000111
110000010000000000000000111100000111100000000000000010000111
110000010000000000000000111100000111100000000000000010000111
110000010000000000000000111100000111100000000000000010000111
110000010000000000000000111100000111100000000000000010000111
110000010000000000000000000000000000000000000000000010000111
110000010000000000000000000000000000000000000000000010000111
110000010000000000000000000000000000000000000000000010000111
110000010000000000000000000000000000000000000000000010000111
110000010000000000000000000000000000000000000000000010000111
110000010000000001000000000000001000000000000000000010000111
110000010000000001000000000000001000000000000000000010000111
110000010000000001000000000000001000000000000000000010000111
110000010000000001000000000000001000000111100000000010000111
110000010000000001111111111111111000000111100000000010000111
110000010000000000000000000000000000000111100000000010000111
110000010000000000000000000000000000000111100000000010000111
110000010000000000000000000000000000000000000000000010000111
110000010000000000000000000000000000000000000000000010000111
110000010000000000000000000000000000000000000000000010000111
110000010000000000000000000000000000000000000000000010000111
110000010000000000000000000000000000000000000000000010000111
110000011111111111111111111111111111111111111111111110000111
110000000000000000000000000000000000000000000000000000000111
110000000000000000000000000000000000000000000000000000000111
110000000000000000000000000000000000000000000000000000000111
110000000000000000000000000000000000000000000000000000000111
110000000000000000000000000000000000000000000000000000000111
110000000000000000000000000000000000000000000000000000000111
110000000000000000000000000000000000000000000000000000000111
110000011111111111111111111110011111111111111111111110000111
110000010000000000000000000000000000000000000000000010000111
110000010000000000000000000000000000000000000000000010000111
110000010000000000000000000000000000000000000000000010000111
110000010000000000000000000000000000000000000000000010000111
110000010000000000000000000000000000000000000000000010000111
110000010000000000000000111100000111100000000000000010000111
110000010000000000000000111100000111100000000000000010000111
110000010000000000000000111100000111100000000000000010000111
110000010000000000000000111100000111100000000000000010000111
110000010000000000000000000000000000000000000000000010000111
110000010000000000000000000000000000000000000000000010000111
110000010000000000000000000000000000000000000000000010000111
110000010000000000000000000000000000000000000000000010000111
110000010000000000000000000000000000000000000000000010000111
110000010000000001000000000000001000000000000000000010000111
110000010000000001000000000000001000000000000000000010000111
110000010000000001000000000000001000000000000000000010000111
110000010000000001000000000000001000000111100000000010000111
110000010000000001111111111111111000000111100000000010000111
110000010000000000000000000000000000000111100000000010000111
110000010000000000000000000000000000000111100000000010000111
110000010000000000000000000000000000000000000000000010000111
110000010000000000000000000000000000000000000000000010000111
110000010000000000000000000000000000000000000000000010000111
110000010000000000000000000000000000000000000000000010000111
110000010000000000000000000000000000000000000000000010000111
110000011111111111111111111111111111111111111111111110000111
110000000000000000000000000000000000000000000000000000000111
110000000000000000000000000000000000000000000000000000000111
111111111111111111111111111111111111111111111111111111111111
