-25
34
-17
89
111111111111111111111111111111111111111111111111111111111111
111111111111111111111111111111111111111111111111111111111111
111111111111111111111111111111111111111111111111111111111111
111111111111111111111111111111111111111111111111111111111111
110000000000000000000000000000000000000000000000000000000111
110000000000000000000000000000000000000000000000000000000111
110000000000000000000000000000000000000000000000000000000111
110000000000000000000000000000000000000000000000000000000111
110000000000000000000000000000000000000000000000000000000111
110000000000000000000000000000000000000000000000000000000111
110000000000000000000000000000000000000000000000000000000111
110000000000000000000000000000000000000000000000000010000111
110000000000000000000000000000000000000000000000000010000111
110000000001111000000000000000000000000000000000000000000111
110000000001111000000000000000000000000001110000000000000111
110000000001111000000000000000000000000001110000000000000111
110000000001111000000000111100000111100000000000000000000111
110000000000000001110000111100000111100000000000000000000111
110000000000000001110000111100000111100000000000000000000111
110000000000000000000000111100000111100000000000000000000111
110000000000000000000000000000000000011100000000000000000111
110000000000000001110000000011100000011100000000000000000111
110000000000000001110000000011100000000000000111000000000111
110000000000000000000000000000000000000000000111000000000111
110000000000000000000000000000000000000111100000000000000111
110000000000000000000001110000001000000111100000000000000111
110000000001110000000001110000000000000111100000000000000111
110000000001110000000000000000000000000111100000000000000111
110000000000000000000000000000000000000111100000000000000111
110000000000000000000001111000000000000111100000000000000111
110000000011110000000001111000000000000111100000000000000111
110000000011110000000001111000000000000111100000000000000111
110000000011110000000001111000000000000000000000000000000111
110000000011100000000000000000111000000000000000000000000111
110000000000000000011110000000111000000000000000011110000111
110000000000000000011110000000000000000000000000011110000111
110000000000000000011110000000000000000000000000011110000111
110000000000000000011110000000000000000000000000011110000111
110000000000000000000000000000000000000000000000000000000111
110000000000000000000000000000000000000000000000000000000111
110000000000000000000000000000000000000000000000000000000111
110000000000000000000000000000000000000000000000000000000111
110000000000000000000000000000000000000000000000000000000111
110000000000000000000000000000000000000000000000000000000111
110000000000000000000000000000000000000000000000000010000111
110000000000000000000000000000000000000000000000000010000111
110000000001111000000000000000000000000000000000000000000111
110000000001111000000000000000000000000001110000000000000111
110000000001111000000000000000000000000001110000000000000111
110000000001111000000000111100000111100000000000000000000111
110000000000000001110000111100000111100000000000000000000111
110000000000000001110000111100000111100000000000000000000111
110000000000000000000000111100000111100000000000000000000111
110000000000000000000000000000000000011100000000000000000111
110000000000000001110000000011100000011100000000000000000111
110000000000000001110000000011100000000000000111000000000111
110000000000000000000000000000000000000000000111000000000111
110000000000000000000000000000000000000000000000000000000111
110000000000000000000001110000001000000000000000000000000111
110000000001110000000001110000000000000111100000000000000111
110000000001110000000000000000000000000111100000000000000111
110000000000000000000000000000000000000111100000000000000111
110000000000000000000001111000000000000111100000000000000111
110000000011110000000001111000000000000111100000000000000111
110000000011110000000001111000000000000111100000000000000111
110000000011110000000001111000000000000000000000000000000111
110000000011110000000000000000111000000000000000000000000111
110000000000000000011110000000111000000000000000011110000111
110000000000000000011110000000000000000000000000011110000111
110000000000000000011110000000000000000000000000011110000111
110000000000000000011110000000000000000000000000011110000111
110000000000000000000000000000000000000000000000000000000111
110000000000000000000000000000000000000000000000000000000111
110000000000000000000000000000000000000000000000000000000111
110000000000000000000000000000000000000000000000000000000111
110000000000000000000000000000000000000000000000000000000111
110000000000000000000000000000000000000000000000000000000111
110000000000000000000000000000000000000000000000000010000111
110000000000000000000000000000000000000000000000000010000111
110000000001111000000000000000000000000000000000000000000111
110000000001111000000000000000000000000001110000000000000111
110000000001111000000000000000000000000001110000000000000111
110000000001111000000000111100000111100000000000000000000111
110000000000000001110000111100000111100000000000000000000111
110000000000000001110000111100000111100000000000000000000111
110000000000000000000000111100000111100000000000000000000111
110000000000000000000000000000000000011100000000000000000111
110000000000000001110000000011100000011100000000000000000111
110000000000000001110000000011100000000000000111000000000111
110000000000000000000000000000000000000000000111000000000111
110000000000000000000000000000000000000000000000000000000111
110000000000000000000001110000001000000000000000000000000111
110000000001110000000001110000000000000000000000000000000111
110000000001110000000000000000000000000000000000000000000111
110000000000000000000000000000000000000111100000000000000111
110000000000000000000001111000000000000111100000000000000111
110000000011110000000001111000000000000111100000000000000111
110000000011110000000001111000000000000111100000000000000111
110000000011110000000001111000000000000000000000000000000111
110000000011110000000000000000111000000000000000000000000111
110000000000000000011110000000111000000000000000011110000111
110000000000000000011110000000000000000000000000011110000111
110000000000000000011110000000000000000000000000011110000111
110000000000000000011110000000000000000000000000011110000111
110000000000000000000000000000000000000000000000000000000111
110000000000000000000000000000000000000000000000000000000111
111111111111111111111111111111111111111111111111111111111111
