-24
33
-17
88
0000000000000000000000000000000000000000000000000000000000
1000000000000000000000000000000000000000000000000000000010
1000000000000000000000000000000000000000000000000000000010
1000000000000000000000000000000000000000000000000000000010
1000000000000000000000000000000000000000000000000000000010
1000001111111111111111111111001111111111111111111111000010
1000001000000000000000000000000000000000000000000001000010
1000001000000000000000000000000000000000000000000001000010
1000001000000000000000000000000000000000000000000001000010
1000001000000000000000000000000000000000000000000001000010
1000001000000000000000000000000000000000000000000001000010
1000001000000000000000011110000011110000000000000001000010
1000001000000000000000011110000011110000000000000001000010
1000001000000000000000011110000011110000000000000001000010
1000001000000000000000011110000011110000000000000001000010
1000001000000000000000000000000000000000000000000001000010
1000001000000000000000000000000000000000000000000001000010
1000001000000000000000000000000000000000000000000001000010
1000001000000000000000000000000000000000000000000001000010
1000001000000000000000000000000000000000000000000001000010
1000001000000000100000000000000100000000000000000001000010
1000001000000000100000000000000100000000000000000001000010
1000001000000000100000000000000100000000000000000001000010
1000001000000000100000000000000100000011110000000001000010
1000001000000000111111111111111100000011110000000001000010
1000001000000000000000000000000000000011110000000001000010
1000001000000000000000000000000000000011110000000001000010
1000001000000000000000000000000000000000000000000001000010
1000001000000000000000000000000000000000000000000001000010
1000001000000000000000000000000000000000000000000001000010
1000001000000000000000000000000000000000000000000001000010
1000001000000000000000000000000000000000000000000001000010
1000001111111111111111111111111111111111111111111111000010
1000000000000000000000000000000000000000000000000000000010
1000000000000000000000000000000000000000000000000000000010
1000000000000000000000000000000000000000000000000000000010
1000000000000000000000000000000000000000000000000000000010
1000000000000000000000000000000000000000000000000000000010
1000000000000000000000000000000000000000000000000000000010
1000000000000000000000000000000000000000000000000000000010
1000001111111111111111111111001111111111111111111111000010
1000001000000000000000000000000000000000000000000001000010
1000001000000000000000000000000000000000000000000001000010
1000001000000000000000000000000000000000000000000001000010
1000001000000000000000000000000000000000000000000001000010
1000001000000000000000000000000000000000000000000001000010
1000001000000000000000011110000011110000000000000001000010
1000001000000000000000011110000011110000000000000001000010
1000001000000000000000011110000011110000000000000001000010
1000001000000000000000011110000011110000000000000001000010
1000001000000000000000000000000000000000000000000001000010
1000001000000000000000000000000000000000000000000001000010
1000001000000000000000000000000000000000000000000001000010
1000001000000000000000000000000000000000000000000001000010
1000001000000000000000000000000000000000000000000001000010
1000001000000000100000000000000100000000000000000001000010
1000001000000000100000000000000100000000000000000001000010
1000001000000000100000000000000100000000000000000001000010
1000001000000000100000000000000100000011110000000001000010
1000001000000000111111111111111100000011110000000001000010
1000001000000000000000000000000000000011110000000001000010
1000001000000000000000000000000000000011110000000001000010
1000001000000000000000000000000000000000000000000001000010
1000001000000000000000000000000000000000000000000001000010
1000001000000000000000000000000000000000000000000001000010
1000001000000000000000000000000000000000000000000001000010
1000001000000000000000000000000000000000000000000001000010
1000001111111111111111111111111111111111111111111111000010
1000000000000000000000000000000000000000000000000000000010
1000000000000000000000000000000000000000000000000000000010
1000000000000000000000000000000000000000000000000000000010
1000000000000000000000000000000000000000000000000000000010
1000000000000000000000000000000000000000000000000000000010
1000000000000000000000000000000000000000000000000000000010
1000000000000000000000000000000000000000000000000000000010
1000001111111111111111111111001111111111111111111111000010
1000001000000000000000000000000000000000000000000001000010
1000001000000000000000000000000000000000000000000001000010
1000001000000000000000000000000000000000000000000001000010
1000001000000000000000000000000000000000000000000001000010
1000001000000000000000000000000000000000000000000001000010
1000001000000000000000011110000011110000000000000001000010
1000001000000000000000011110000011110000000000000001000010
1000001000000000000000011110000011110000000000000001000010
1000001000000000000000011110000011110000000000000001000010
1000001000000000000000000000000000000000000000000001000010
1000001000000000000000000000000000000000000000000001000010
1000001000000000000000000000000000000000000000000001000010
1000001000000000000000000000000000000000000000000001000010
1000001000000000000000000000000000000000000000000001000010
1000001000000000100000000000000100000000000000000001000010
1000001000000000100000000000000100000000000000000001000010
1000001000000000100000000000000100000000000000000001000010
1000001000000000100000000000000100000011110000000001000010
1000001000000000111111111111111100000011110000000001000010
1000001000000000000000000000000000000011110000000001000010
1000001000000000000000000000000000000011110000000001000010
1000001000000000000000000000000000000000000000000001000010
1000001000000000000000000000000000000000000000000001000010
1000001000000000000000000000000000000000000000000001000010
1000001000000000000000000000000000000000000000000001000010
1000001000000000000000000000000000000000000000000001000010
1000001111111111111111111111111111111111111111111111000010
1000000000000000000000000000000000000000000000000000000010
1000000000000000000000000000000000000000000000000000000010
1000000000000000000000000000000000000000000000000000000010
